Symbol|Security Name|Market Category|Reg SHO Threshold Flag|Rule 3210|Filler
ABLE|ABLE ENERGY INC|u|Y|N|
ACTC|ADVANCED CELL TECHNOLOGY, INC.|U|Y|N|
ADRU|BLDRS EUROPE 100 ARR|G|Y|N|
ADSO|ADSERO CORP|u|Y|N|
AFML|Aerofoam Metals Inc. Common St|u|Y|N|
AGIX|ATHEROGENICS INC|G|Y|N|
AGSI|AEGIS ASSESSMENTS INC|U|Y|N|
AGTA|ARGENTA SYSTEMS, INC.|U|Y|N|
AITP|AMERICAN ITALIAN PASTA CL-A|u|Y|N|
AKSY|AKSYS LTD|u|Y|N|
AMGZO|AMG Capital Trust 1 5.1% Tr Pf|u|N|Y|
AMRX|AmerElite Solutions, Inc. New|u|N|Y|
AMTCW|AMERITRANS CAPITAL CORPORATION|S|Y|N|
AQPTY|AQUARIUS PLATINUM LTD SPNS ADR|u|N|Y|
AQUA|AQUACELL TECH INC|u|Y|N|
ASGLY|ASAHI GLASS ADR|u|N|Y|
ASVI|A S V INC|Q|Y|N|
AUAYF|Adanac Molybdenum Corporation|u|N|Y|
AXTG|Axis Technologies Group, Inc.|u|N|Y|
AZTN|AMAZING TECHNOLOGIES CORPORATI|u|N|Y|
BDCO|BLUE DOLPHIN ENERGY CORP|S|Y|N|
BIDU|BAIDU.COM, INC. SPON ADR RPTNG|G|Y|N|
BNVI|BIONOVO, INC|U|Y|N|
BRRAY|BARLOWORLD LTD ADR|u|N|Y|
BRRSF|BEAR RIDGE RES LTD|u|N|Y|
CAIGY|ELETROBRAS CENTRAIS ADR (PRF)|u|N|Y|
CBLI|CLEVELAND BIOLABS INC COM STK|S|Y|N|
CGWVF|CONSOLDATED GD WIN VENT INC-F|u|N|Y|
CIMK|CIMNET INC|U|Y|N|
CINT|CRYSTAL INTL TRAVEL GROUP COM|U|Y|N|
CLRC|Clear Choice Financial, Inc. C|U|Y|N|
CLRI|CLEARANT, INC.|U|Y|N|
CNLG|CONOLOG CORPORATION NEW|S|Y|N|
CONX|CORGENIX MEDICAL CORP-NEW|U|Y|N|
CORS|CORUS BANKSHARES INC|Q|Y|N|
CPST|CAPSTONE TURBINE CORP|G|Y|N|
CRWP|CROWN PARTNERS INC|U|Y|N|
CSEBF|Canadian Sub-Surface Energy Co|u|N|Y|
CTEL|CITY TELECOM (H.K.) LTD ADS|G|Y|N|
CTPMF|CONTINENTAL PRECIOUS MINERALS|u|N|Y|
CTXNY|CONTAX PARTICIPACOES SA SPONSO|u|N|Y|
CUBA|HERZFELD CARIBBEAN BASIN FUND|S|Y|N|
CVCP|Cavico Corporation Common Stoc|u|Y|N|
CVGFY|CORPORACION GEO SA DE CV SPONS|u|N|Y|
CWIR|CENTRAL WIRELESS INC|u|Y|N|
CXTI|CHINA EXPERT TECHNOLOGY INC|U|Y|N|
CXXUF|CROSSHAIR EXPLORATION & MINING|u|N|Y|
CYKN|CYBERKINETICS NEUROTECHNOLOGY|U|Y|N|
CYSG|CAPE SYSTEMS GROUP, INC.|U|Y|N|
CYTO|CYTOGEN CORP COM NEW|G|Y|N|
DALRQ|DELTA AIR LINES INC DEL|u|Y|N|
DAQC|Diners Acquisition Corp. Commo|U|Y|N|
DJEEF|DEJOUR ENTERPRISES LTD NEW|U|Y|N|
DMLCF|Denison Mines Corp Ordinary Sh|u|N|Y|
DNAG|DNAPRINT GENOMICS INC. NEW|U|Y|N|
DPBL|Deep Blue, Inc. Common Stock|u|Y|N|
DSNY|DESTINY MEDIA TECH INC-NEW|U|Y|N|
DSTI|DAYSTAR TECHNOLOGIES INC|S|Y|N|
EFUT|E-FUTURE INFORMATION TECHNOLOG|S|Y|N|
EGFDF|EUROPEAN GOLDFIELDS LTD|u|N|Y|
EMMS|EMMIS COMMUNICATIONS CRP CL A|Q|Y|N|
ESCL|ESCALA GROUP INC|u|Y|N|
EVCC|Environmental Control Corp. Co|U|Y|N|
EXCS|EXECUTE SPORTS, INC.|U|Y|N|
EXLLF|EXCELLON RESOURCES INC (F)|u|N|Y|
FAAC|FORTRESS AMERICA ACQUISITION C|U|Y|N|
FBOR|FBO AIR INC|U|Y|N|
FCCN|FRANCHSISE CAPITAL CORP|u|Y|N|
FCNRE|Falcon Ridge Development, Inc.|U|Y|N|
FDSAW|FEDERAL SERVICES ACQUISITION C|U|Y|N|
FDSM|4D SEISMIC INC COM STK|u|Y|N|
FESVF|FLINT ENERGY SVCS LTD (CDA)|u|N|Y|
FETCF|FAR EASTONE TELECOMM CO LTD SP|u|N|Y|
FLIP|FTS GROUP INC|U|Y|N|
FMDAD|FUTUREMEDIA PUBLIC LIMITED CO|S|Y|N|
FOLGF|FALCON OIL & GAS LTD|u|N|Y|
FORD|FORWARD INDUSTRIES INC|S|Y|N|
FVITF|FORTUNA SILVER MINES, INC.|u|N|Y|
GACF|GLOBAL AIRCRAFT SOLUTIONS INC|U|Y|N|
GEGQQ|GLOBAL POWER EQUIPMENT GP|u|Y|N|
GETI|GENTEK INC NEW|Q|Y|N|
GGBMW|GIGABEAM CORP WARRANT 10/13/20|S|Y|N|
GHLT|GHL TECHNOLOGIES INC COM STK|u|N|Y|
GMXR|GMX RESOURCES INC|G|Y|N|
GNLAF|GENESIS LAND DEV CORP|u|N|Y|
GOAM|GO AMERICA INC NEW|S|Y|N|
GROW|US GLOBAL INVESTORS INC CL-A|S|Y|N|
GRWW|GREENS WORLDWIDE INC NEW|U|Y|N|
GSPG|GOLDSPRING INC.|U|Y|N|
GTEM|GLOBETEL COMMUNICATIONS CORP C|u|Y|N|
HBDT|HEALTH BENEFITS DIRECT CORPORA|U|Y|N|
HIET|HIENERGY TECHNOLOGIES, INC. (D|U|Y|N|
HQSM|HQ SUSTAINABLE MARITIME INDUST|U|Y|N|
HXPN|HARRIS EXPORATION INC NEW|u|N|Y|
HYDG|HYDROGEN CORP|U|Y|N|
IAAC|INTL ASSET HOLDING CORP|S|Y|N|
IFLI|International Fight League, In|U|Y|N|
IFON|INFOSONICS CORPORATION|G|Y|N|
IMJX|IMAGEXPRESS INC|u|Y|N|
INXI|INX, INC.|S|Y|N|
IPIXQ|IPIX CORPORATION|u|Y|N|
IRBL|INROB TECH, LTD|U|Y|N|
IRSN|IRVINE SENSORS CORP NEW|S|Y|N|
ISBL|Ise Blu Equity Corp Common Sto|u|Y|N|
ISRY|ISORAY INC|U|Y|N|
ITCC|I T C LEARNING CORP|u|Y|N|
IVXFF|INNOVA EXPL LTD|u|N|Y|
JMPVF|JUMPTV INC COM STK|u|N|Y|
JRCC|JAMES RIVER COAL NEW|G|Y|N|
KGFHY|KINGFISHER PLC SPON ADR(NEW)|u|N|Y|
LMRA|LUMERA CORP|G|Y|N|
LMRXF|LARAMIDE RESOURCES LTD|u|N|Y|
MAMA|MAMMA COM INC|S|Y|N|
MAUXF|MART RESOURCES INC (F)|u|N|Y|
MBND|MULTIBAND CORP|S|Y|N|
MDTL|MEDIS TECHNOLOGIES LTD|G|Y|N|
MEAD|MEADE INSTRUMENTS CORP|G|Y|N|
MGAFF|MEGA URANIUM LTD (CANADA)|u|N|Y|
MHLOF|Mahalo Energy Ltd Common Share|u|N|Y|
MKGDU|MIDDLE KINGDOM ALLIANCE CORP U|U|Y|N|
MOBL|MOBILEPRO CORP-NEW|U|Y|N|
MOVT|MOTIVNATION INC NEW|U|Y|N|
MSMAW|MILLSTREAM II ACQUISITION CORP|U|Y|N|
MSTRW|MICROSTRATEGY INC|Q|Y|N|
MTOGF|MOTO GOLDMINES LTD ORD SHS (CA|u|N|Y|
MTXX|MATRIXX INITIATIVES INC|Q|Y|N|
MWSNF|MAWSON RES LTD|u|N|Y|
NAVR|NAVARRE CORP|G|Y|N|
NAWL|NATUREWELL INC|U|Y|N|
NEMFF|Neo Material Technologies Inc|u|N|Y|
NFLD|NORTHFIELD LABORATORIES INC|G|Y|N|
NHYB|NATIONAL HYPERBARIC REHAB CTN|u|Y|N|
NIHK|NIGHTHAWK SYS INC|U|Y|N|
NPUCF|NORTHERN PERU COPPER CORP|u|N|Y|
NRLS|Neuralstem, Inc. Common Stock|U|Y|N|
NRMX|NEUROCHEM INC|G|Y|N|
NURO|NEUROMETRIX INC|G|Y|N|
NVEC|NVE CORPORATION NEW|S|Y|N|
NWBT|NORTHWEST BIOTHERAPEUTICS INC|U|Y|N|
OBBCQ|ORBIT BRANDS CORPORATION|u|Y|N|
OBCI|OCEAN BIO-CHEM INC|S|Y|N|
OIVO|One IP Voice, Inc. Common Stoc|U|Y|N|
ONEQ|FIDELITY NASDAQ COMPOSITE INDE|G|Y|N|
ONSM|ONSTREAM MEDIA CORP|S|Y|N|
OSIIF|OSI Geospatial Inc. Ordinary S|U|Y|N|
OSTK|OVERSTOCK COM INC DEL|G|Y|N|
OTCI|Ortec International, Inc. New|U|Y|N|
OTLK|Otter Lake Resources, Inc. New|u|Y|N|
OXMI|OXFORD MEDIA, INC.|U|Y|N|
PARL|PARLUX FRAGRANCES INC|Q|Y|N|
PDVP|Podium Venture Group, Inc. Com|u|Y|N|
PEIX|PACIFIC ETHANOL, INC.|G|Y|N|
PGSW|Pegasus Wireless Corp. (NV) Ne|U|Y|N|
PHTW|PHOTOWORKS INC. NEW|U|Y|N|
PMRS|PREMIER MORTGAGE RES INC-NEW|u|Y|N|
PNPFF|PINETREE CAPITAL LTD|u|N|Y|
PRKR|PARKERVISION INC|G|Y|N|
PRTH|PRIME TIME HOLDINGS INC|u|N|Y|
PSDV|PSIVIDA LTD ADR|G|Y|N|
PTRN|Patron Systems, Inc. New Commo|U|Y|N|
PWEI|PW EAGLE INC|G|Y|N|
PWNX|POWERLINX INC NEW|U|Y|N|
QMMG|QUEST MINERALS & MINING INC|U|Y|N|
QMMI|Q COMM INTERNATIONAL INC NEW|u|Y|N|
QTWW|QUANTUM FUEL SYS TECHNOLOGIES|G|Y|N|
RCOQF|QUALITY DINO ENTERTAINMNT LTD|u|Y|N|
REDI|REMOTE DYNAMICS INC|U|Y|N|
RGRP|ROO GROUP INC NEW|U|Y|N|
RLYGF|RALLY ENERGY CORP (F)|u|N|Y|
RMTR|RAMTRON INTERNATIONAL CORP|G|Y|N|
RPSDW|RHAPSODY ACQUSITION CORP WARRA|U|Y|N|
RSUR|Remote Surveillance Technologi|u|Y|N|
RVXCF|RESVERLOGIX CORP|u|N|Y|
SBMRY|SABMILLER PLC SPONSORED ADR|u|N|Y|
SEHO|SENSE HOLDINGS INC|U|Y|N|
SEKEY|SEIKO EPSON CORP UNSPONSORED A|u|N|Y|
SFLK|SAFLINK CORP-NEW|S|Y|N|
SGAMY|SEGA SAMMY HLDGS INC SPONS ADR|u|N|Y|
SGRNF|SERENGETI RESOURCES INC|u|N|Y|
SHNDU|SHINE MEDIA ACQUISITON CORP UT|U|Y|N|
SMFJY|SUMITOMO MITSUI FINL GROUP INC|u|N|Y|
SMKG|SMART CARD MARKETING SYSTEMS I|u|Y|N|
SNLAY|SINO LTD SPON ADR|u|N|Y|
SONT|SONTRA MED CORP NEW|u|Y|N|
SPBU|Spare Backup, Inc. Common Stoc|U|Y|N|
SPKFF|SPARK NETWORKS PLC SPONSORED R|u|N|Y|
SPWR|SUNPOWER CORPORATION CL A|G|Y|N|
SXRFF|SXR URANIUM ONE INC|u|N|Y|
TELK|TELIK, INC|G|Y|N|
TISCY|TAISEI CORP ADR|u|N|Y|
TNVA|TERRA NOVA ACQUISITION CORP|U|Y|N|
TRLG|TRUE RELIGION APPAREL INC|G|Y|N|
TUIJF|TRUE ENERGY TRUST TR UT (CANAD|u|N|Y|
TXLA|TEXOLA ENERGY CORP|U|Y|N|
UAEYF|Urasia Energy Ltd Common Share|u|N|Y|
UAMNF|URAMIN INC REG SHS (BRITISH VI|u|N|Y|
UBHI|UBID.COM HOLDINGS INC|U|Y|N|
UNRG|UNITED ENERGY CORP NEV|U|Y|N|
URNAF|URBANA CORP (F)|u|N|Y|
USSE|U.S. Sustainable Energy Corp.|u|N|Y|
USWF|US WIND FARMING INC|u|Y|N|
VNAA|VEIN ASSOCIATES OF AMERICA, IN|u|N|Y|
VYGO|VOYAGER PETROLEUM, INC COM|U|Y|N|
WBKA|Waterbank of America (USA) Inc|U|Y|N|
WBMD|WEBMD HEALTH CORP CL A|Q|Y|N|
WIRE|ENCORE WIRE CORP|Q|Y|N|
WITM|WITS BASIN PRECIOUS MINERALS I|U|Y|N|
WLFFF|WOLFDEN RESOURCES INC ORD SHS|u|N|Y|
WLSA|WIRELESS AGE COMMUNICATIONS IN|U|Y|N|
WSDT|WISDOMTREE INVESTMENTS, INC.|u|N|Y|
WWSI|WORLDWIDE STRATEGIES INC|u|Y|N|
XDSL|MPHASE TECHNOLOGIES INC|U|Y|N|
XTLB|XTL BIOPHARMACEUTICALS AMERICA|G|Y|N|
ZOLT|ZOLTEK COMPANIES INC|G|Y|N|
ZVUE|HANDHELD ENTERTAINMENT INC COM|S|Y|N|
20070125232501
